0000000000SD0000000000
0000000000==0000000000
0000000000==0000000000
0000000000==0000000000
0000000000==0000000000
0000000000==0000000000
D=========22=========S
S=========22=========D
0000000000==0000000000
0000000000==0000000000
0000000000==0000000000
0000000000==0000000000
0000000000==0000000000
0000000000==0000000000
0000000000==0000000000
0000000000==0000000000
0000000000==0000000000
D=========22=========S
S=========22=========D
0000000000==0000000000
0000000000==0000000000
0000000000==0000000000
0000000000==0000000000
0000000000DS0000000000